node_name	linked_nodes	is_exact	type
1587_3199	1599_3221	0	0
1599_3221	1587_3199,1614_3245	0	0
1614_3245	1599_3221,1631_3269	0	0
1631_3269	1614_3245,1642_3291	0	0
1642_3291	1631_3269,1650_3313	0	0
1650_3313	1631_3331,1642_3291	0	0
1631_3331	1616_3348,1650_3313	0	0
1616_3348	1604_3365,1631_3331	0	0
1604_3365	1591_3379,1616_3348	0	0
1591_3379	1571_3399,1604_3365	0	0
1571_3399	1548_3399,1591_3379	0	0
1548_3399	1528_3418,1571_3399	0	0
1528_3418	1504_3438,1548_3399	0	0
1504_3438	1487_3439,1528_3418	0	0
1487_3439	1477_3439,1504_3438	0	0
1477_3439	1453_3451,1487_3439	0	0
1453_3451	1435_3460,1477_3439	0	0
1435_3460	1424_3471,1453_3451	0	0
1424_3471	1413_3452,1435_3460	0	0
1413_3452	1399_3432,1424_3471	0	0
1399_3432	1391_3414,1413_3452	0	0
1391_3414	1381_3397,1399_3432	0	0
1381_3397	1376_3386,1391_3414	0	0
1376_3386	1359_3365,1381_3397	0	0
1359_3365	1341_3348,1376_3386	0	0
1341_3348	1323_3320,1359_3365	0	0
1323_3320	1318_3299,1341_3348	0	0
1318_3299	1298_3285,1323_3320	0	0
1298_3285	1288_3264,1318_3299	0	0
1288_3264	1298_3285,1308_3246	0	0
1308_3246	1288_3264,1329_3227	0	0
1329_3227	1308_3246,1349_3211	0	0
1349_3211	1329_3227,1366_3191	0	0
1366_3191	1349_3211,1382_3166	0	0
1382_3166	1366_3191,1405_3148	0	0
1405_3148	1382_3166,1414_3133	0	0
1414_3133	1405_3148,1428_3122	0	0
1428_3122	1414_3133,1441_3130	0	0
1441_3130	1428_3122,1453_3142	0	0
1453_3142	1441_3130,1479_3164	0	0
1479_3164	1453_3142,1497_3180	0	0
1497_3180	1479_3164,1488_3195,1497_3180,1511_3202	0	0
1488_3195	1468_3194,1497_3180	0	0
1468_3194	1452_3213,1488_3195	0	0
1452_3213	1438_3223,1468_3194	0	0
1438_3223	1424_3240,1452_3213	0	0
1424_3240	1401_3257,1438_3223	0	0
1401_3257	1407_3284,1424_3240	0	0
1407_3284	1401_3257,1418_3310	0	0
1418_3310	1407_3284,1428_3344	0	0
1428_3344	1418_3310,1446_3368	0	0
1446_3368	1428_3344,1467_3357	0	0
1467_3357	1446_3368,1498_3342	0	0
1498_3342	1467_3357,1520_3327	0	0
1520_3327	1498_3342,1536_3309	0	0
1536_3309	1520_3327,1544_3282	0	0
1544_3282	1536_3256,1536_3309	0	0
1536_3256	1524_3225,1544_3282	0	0
1524_3225	1511_3202,1536_3256	0	0
1511_3202	1497_3180,1524_3225	0	0
1579_3186	1584_3197,1375_3273	0	1
1584_3197	1579_3186,1592_3206	0	1
1592_3206	1584_3197,1598_3216	0	1
1598_3216	1592_3206,1604_3228	0	1
1604_3228	1598_3216,1607_3239	0	1
1607_3239	1604_3228,1613_3249	0	1
1613_3249	1607_3239,1618_3260	0	1
1618_3260	1613_3249,1626_3269	0	1
1626_3269	1618_3260,1632_3280	0	1
1632_3280	1626_3269,1640_3290	0	1
1640_3290	1632_3280,1645_3297	0	1
1645_3297	1640_3290,1653_3308	0	1
1653_3308	1645_3297,1661_3301,1645_3317	0	1
1661_3301	1653_3308,1668_3289	0	1
1668_3289	1661_3301	0	1
1645_3317	1653_3308,1636_3326	0	1
1636_3326	1645_3317,1629_3334	0	1
1629_3334	1636_3326,1621_3342	0	1
1621_3342	1629_3334,1609_3354	0	1
1609_3354	1621_3342,1604_3362,1604_3343	0	1
1604_3362	1609_3354,1597_3370	0	1
1597_3370	1604_3362,1591_3377	0	1
1591_3377	1597_3370,1585_3383	0	1
1585_3383	1591_3377,1577_3386	0	1
1577_3386	1585_3383,1568_3391	0	1
1568_3391	1577_3386,1558_3395	0	1
1558_3395	1568_3391,1548_3398	0	1
1548_3398	1558_3395,1541_3407	0	1
1541_3407	1548_3398,1534_3411	0	1
1534_3411	1541_3407,1525_3413	0	1
1525_3413	1534_3411,1518_3419	0	1
1518_3419	1525_3413,1510_3427	0	1
1510_3427	1518_3419,1503_3434	0	1
1503_3434	1510_3427,1494_3439	0	1
1494_3439	1503_3434,1485_3444	0	1
1485_3444	1494_3439,1476_3441	0	1
1476_3441	1485_3444,1466_3445	0	1
1466_3445	1476_3441,1460_3447	0	1
1460_3447	1466_3445,1453_3452	0	1
1453_3452	1460_3447,1446_3455	0	1
1446_3455	1453_3452,1440_3458	0	1
1440_3458	1446_3455,1433_3464	0	1
1433_3464	1440_3458,1426_3470	0	1
1426_3470	1433_3464,1420_3459	0	1
1420_3459	1426_3470,1413_3455	0	1
1413_3455	1420_3459,1409_3446	0	1
1409_3446	1413_3455,1402_3444	0	1
1402_3444	1409_3446,1400_3436	0	1
1400_3436	1402_3444,1398_3425	0	1
1398_3425	1400_3436,1394_3417	0	1
1394_3417	1398_3425,1388_3408	0	1
1388_3408	1394_3417,1382_3408	0	1
1382_3408	1388_3408,1380_3397	0	1
1380_3397	1382_3408,1377_3390	0	1
1377_3390	1380_3397,1370_3382	0	1
1370_3382	1377_3390,1365_3374	0	1
1365_3374	1370_3382,1359_3370	0	1
1359_3370	1365_3374,1351_3367	0	1
1351_3367	1359_3370,1344_3358	0	1
1344_3358	1351_3367,1342_3347	0	1
1342_3347	1344_3358,1338_3338	0	1
1338_3338	1342_3347,1336_3329	0	1
1336_3329	1338_3338,1331_3318	0	1
1331_3318	1336_3329,1325_3311,1339_3309	0	1
1325_3311	1331_3318,1319_3303	0	1
1319_3303	1325_3311,1314_3294	0	1
1314_3294	1319_3303,1308_3287	0	1
1308_3287	1314_3294,1299_3282	0	1
1299_3282	1308_3287,1291_3273	0	1
1291_3273	1299_3282,1288_3263	0	1
1288_3263	1291_3273,1281_3255,1297_3258	0	1
1281_3255	1288_3263,1274_3248	0	1
1274_3248	1281_3255,1263_3241	0	1
1263_3241	1274_3248	0	1
1339_3309	1331_3318,1348_3302	0	1
1348_3302	1339_3309,1356_3301	0	1
1356_3301	1348_3302,1362_3291	0	1
1362_3291	1356_3301,1369_3282	0	1
1369_3282	1362_3291,1375_3273	0	1
1375_3273	1579_3186,1369_3282,1382_3268	0	1
1382_3268	1375_3273,1389_3272,1395_3254	0	1
1389_3272	1382_3268,1401_3276	0	1
1401_3276	1389_3272,1405_3289,1405_3266	0	1
1405_3289	1401_3276,1410_3301	0	1
1410_3301	1405_3289,1412_3313	0	1
1412_3313	1410_3301,1418_3324	0	1
1418_3324	1412_3313,1425_3337	0	1
1425_3337	1418_3324,1431_3347	0	1
1431_3347	1425_3337,1438_3356	0	1
1438_3356	1431_3347,1443_3366	0	1
1443_3366	1438_3356,1452_3360	0	1
1452_3360	1443_3366,1460_3362	0	1
1460_3362	1452_3360,1470_3361	0	1
1470_3361	1460_3362,1479_3359	0	1
1479_3359	1470_3361,1488_3352	0	1
1488_3352	1479_3359,1497_3345	0	1
1497_3345	1488_3352,1506_3338	0	1
1506_3338	1497_3345,1515_3334	0	1
1515_3334	1506_3338,1524_3326	0	1
1524_3326	1515_3334,1532_3318	0	1
1532_3318	1524_3326,1538_3307	0	1
1538_3307	1532_3318,1545_3298	0	1
1545_3298	1538_3307,1554_3284	0	1
1554_3284	1545_3298,1562_3290,1547_3274	0	1
1562_3290	1554_3284,1570_3297	0	1
1570_3297	1562_3290,1578_3305	0	1
1578_3305	1570_3297,1584_3312	0	1
1584_3312	1578_3305,1591_3322	0	1
1591_3322	1584_3312,1597_3332	0	1
1597_3332	1591_3322,1604_3343	0	1
1604_3343	1609_3354,1597_3332	0	1
1405_3266	1401_3276,1404_3249	0	1
1404_3249	1405_3266,1395_3254,1413_3242	0	1
1395_3254	1382_3268,1404_3249	0	1
1413_3242	1404_3249,1422_3234	0	1
1422_3234	1413_3242,1433_3231	0	1
1433_3231	1422_3234,1444_3225	0	1
1444_3225	1433_3231,1449_3237,1443_3211	0	1
1449_3237	1444_3225,1456_3247	0	1
1456_3247	1449_3237,1465_3257	0	1
1465_3257	1456_3247,1470_3267	0	1
1470_3267	1465_3257,1475_3276	0	1
1475_3276	1470_3267	0	1
1443_3211	1444_3225,1453_3208	0	1
1453_3208	1443_3211,1464_3205	0	1
1464_3205	1453_3208,1472_3197	0	1
1472_3197	1464_3205,1479_3191	0	1
1479_3191	1472_3197,1487_3176	0	1
1487_3176	1479_3191,1495_3187,1481_3165	0	1
1495_3187	1487_3176,1501_3197	0	1
1501_3197	1495_3187,1509_3208	0	1
1509_3208	1501_3197,1516_3215	0	1
1516_3215	1509_3208,1524_3225	0	1
1524_3225	1516_3215,1530_3232	0	1
1530_3232	1524_3225,1536_3242	0	1
1536_3242	1530_3232,1541_3255	0	1
1541_3255	1536_3242,1545_3265	0	1
1545_3265	1541_3255,1547_3274	0	1
1547_3274	1554_3284,1545_3265	0	1
1481_3165	1487_3176,1473_3156	0	1
1473_3156	1481_3165,1465_3147	0	1
1465_3147	1473_3156,1456_3140	0	1
1456_3140	1465_3147,1446_3136	0	1
1446_3136	1456_3140,1439_3130	0	1
1439_3130	1446_3136,1430_3125	0	1
1430_3125	1439_3130,1420_3124	0	1
1420_3124	1430_3125,1420_3110,1413_3133	0	1
1420_3110	1420_3124,1425_3101	0	1
1425_3101	1420_3110	0	1
1413_3133	1420_3124,1406_3141	0	1
1406_3141	1413_3133,1399_3150	0	1
1399_3150	1406_3141,1394_3158	0	1
1394_3158	1399_3150,1386_3167	0	1
1386_3167	1394_3158,1380_3176	0	1
1380_3176	1386_3167,1372_3183	0	1
1372_3183	1380_3176,1367_3191	0	1
1367_3191	1372_3183,1360_3199	0	1
1360_3199	1367_3191,1353_3205	0	1
1353_3205	1360_3199,1346_3211	0	1
1346_3211	1353_3205,1339_3217	0	1
1339_3217	1346_3211,1331_3223	0	1
1331_3223	1339_3217,1327_3231	0	1
1327_3231	1331_3223,1319_3237	0	1
1319_3237	1327_3231,1311_3243	0	1
1311_3243	1319_3237,1303_3249	0	1
1303_3249	1311_3243,1297_3258	0	1
1297_3258	1288_3263,1303_3249	0	1