node_name	linked_nodes	is_exact	type
1610_3203	1615_3187	0	1
1615_3187	1610_3203,1607_3169	0	1
1607_3169	1615_3187,1609_3128	0	1
1609_3128	1607_3169,1653_3131,1516_3075	0	1
1653_3131	1609_3128	0	1
1516_3075	1609_3128	0	1