node_name	linked_nodes	is_exact	type
1590_3171	2013_3212,1631_3520,1786_3346	0	1
2013_3212	1590_3171,1991_4063,1786_3346,1959_3605	0	1
1991_4063	2013_3212,1637_3995,1959_3605,1825_3834	0	1
1637_3995	1991_4063,1631_3520,1825_3834	0	1
1631_3520	1590_3171,1637_3995,1786_3346	0	1
1786_3346	1590_3171,2013_3212,1631_3520,1959_3605	0	1
1959_3605	2013_3212,1991_4063,1786_3346,1825_3834	0	1
1825_3834	1991_4063,1637_3995,1959_3605	0	1